11111111111111111
1E000000100000001
1000C0000000C0001
11111110P01111111
1000C0000000C0001
100000001000000E1
11111111111111111